これ = ce, ceci
それ = ce, cela
あれ = ce, cela
ほん = livre
じしょ = dictionnaire
ざっし = magazine, revue
しんぶん = journal
ノート = cahier
てちょう = carnet, agenda
めいし = carte de visite
カード = carte
テレホンカード = carte de téléphone
えんぴつ = crayon
ボールペン = stylo à bille
シャープペンシル = porte-mine
かぎ = clé
とけい = montre, horloge, réveil
かさ = parapluie
かばん = sac, cartable, serviette
カセットテープ, テープ = cassette
テープレコーダー = magnétophone
テレビ = télévision
ラジオ = radio
カメラ = appareil-photo
コンピューター = ordinateur
じどうしゃ = voiture
つくえ = bureau
いす = chaise
チョコレート = chocolat
コーヒー = café
えいご = anglais, la langue anglaise
にほんご = japonais, la langue japonaise
なん = que, quoi, qu'est-ce que