わたし = je, moi
わたしたち = nous
あなた = tu, vous
あのひと, あのかた = cette personne, il, lui, elle
みなさん = tous, vous tous, Mesdames Mesdemoiselles et Messieurs
せんせい = professeur, instituteur
きょうし = professeur, instituteur
がくせい = étudiant
かいしゃいん = employé d'une compagnie
IMCのしゃいん = employé de IMC
ぎんこういん = employé de banque
いしゃ = médecin, docteur
けんきょうしゃ = chercheur
エンジニア = ingénieur
だいがく = université
びょういん = hôpital
でんき = électricité, lampe, lumière
だれ, どなた = qui
さい = âge
なんさい, おいくつ = quel âge
はい = oui
いいえ = non
はじめまして = Enchanté
アメリカ = Amérique
イギリス = Angleterre
インド = Inde
インドネシア = Indonésie
かんこく = Corée
タイ = Thaïlande
ちゅうごく = Chine
ドイツ = Allemagne
にほん = Japon
フランス = France
ブラジル = Brésil